BBBBBBBBBBBBBBBBBBBBBBBBBBBBBBBBBBBBBBBB#
B   H                          H       B#
B    L                  BBBBBBBBBBBBBBBB#
B                                  M   B#
B  M                      BBBBBBBBBBBBBB#
B                                      B#
B          H                           B#
B                        M             B#
B                                      B#
B                                      B#
B       B       H                      B#
B       M         B           M        B#
B                                      B#
B     BBBBBBBBBBBB          BBBBBBBBBBBB#
B     B                     B    M     B#
B     B     BBBBBB          B          B#
B     B     M    B          B      M   B#
B     BBBBBBBBBBBB          B          B#
B          H                           B#
BBBBBBBBBBBBBBBBBBBBBBBBBBBBBBBBBBBBBBBB#