d               d               d               d               d               d               d               d               d               d               d               d               d               d               d               d















d               d               d               d               d       M       d               d               d       L       d               d               d               d               d               d               d               d















d               d               d               d               d               d               d               d               d               d               d               d               d               d               d               d















d               d               d               d               d               d               d               d               d               d               d               d               d               d   H           d               d















d               d               d               d               d               d               d               d               d               d               d               d               d               d               d               d















d               d               d               d               d               d               d               d               d               d               d               d               d               d               d               d















d               d               d               d               d               d               d               d               d               d               d               d               d               d               d               d















d               d      H        d               d               d               d               d               d               d               d               d               d               d               d               d               d















d               d               d               d               d               d               d               d               d               d               d               d               d               d               d               d