d               d               d               d               d               d               d               d               d               d               d               d               d               d               d               d















d               d               d               d               d               d               d               d       L       d               d               d               d               d               d               d               d















d               d               d               d               d               d               d               d               d               d               d               d               d               d               d               d















d               d               d               d               d               d               d               d               d               d               d               d               d               d   H           d               d















d               d               d               d               d               d               d               W                d               d               d               d               d               d               d               d















d               d               d               d               d               d               d               d               d               d               d               d               d               d               d               d















d               d               d               d               d               d               d               d               d               d               d               d               d               d               d               d















d               d      H        d               d               d               d               d               d               d               d               d               d               d               d               d               d















d               d               d               d               d               d               d               d               d               d               d               d               d               d               d               d